######@@@@@@########
#####@@@@@@@@#######
##@@@@@@@@@@@@@@####
@@@@@@@@#@@@@@@@@@@@
@@@@@@#@@@@@####@@@@
@@@@@#@@@@@@@@@@@@@@
@@@@@###@@@@@@@@@@@@
#@@@@@@@@@@@@@@@####
###@@@@@@@@@@@######
########@@@@@@######
####@@@@@@##########
#####@@@@@@@@@@@@@##
##@@@@@@@@@@@@@@@@@@
@@@@@@@@#@@@@@@@@@@@
@@@@@@#@@@@@####@@@@
@@@@@#@@@@@@@@@@@@@@
@@@@@###@@@@@@@@@@@@
#@@@@@@@@@@@@@@@####
###@@@@@@@@@@@######
########@@@@X@######
####@@@@@@##########
#####@@@@@@@@@@@@@##
##@@@@@#@@@@@@@@@@##
@@@@@@#@@@@@@@@@@@@@
@@@@@@@##@@@@@@@@@@@
@@@@@@@@##@@@@@@@@##
#@@@@@####@@@@@@@@@@
##@@@@@@@@@@@@@@####
####@@@@@@@@@@######
#######@@@@@@#######